a - V
al - VC
ve - CV
bir - CVC
ilk - VCC
iki - VCV
şii - CVV
kro - CCV
ayma - VCCV
dört - CVCC
kedi - CVCV
ilik - VCVC
obua - VCVV
aile - VVCV
tren - CCVC
prens - CCVCC
ödünç - VCVVC
badem - CVCVC
yolcu - CVCCV
arttı - VCCCV
uzsal - VCCVC
ileri - VCVCV
havai - CVCVV
teori - CVVCV
geoit - CVVVC
prova - CCVCV
geldi - CVCCV
facia - CVCVV
aidat - VVCVC
ideal - VCVVC
deist - CVVCC
emtia - VCCVV
fleol - CCVVC
sfenks - CCVCCC
makine - CVCVCV
geldik - CVCCVC
özveri - VCCVCV
iletim - VCVCVC
üzümlü - VCVCCV
tostçu - CVCCCV
sporcu - CCVCCV
kriter - CCVCVC
daimdi - CVVCCV
üstsel - VCCCVC
zoolog - CVVCVC
züğürt - CVCVCC
ziraat - CVCVVC
artist - VCCVCC
iadesi - VVCVCV
iguana - VCVVCV
azrail - VCCVVC
aitlik - VVCCVC
stoacı - CCVVCV
beddua - CVCCVV
spreyi - CCCVCV
egoist - VCVVCC
ekstra - VCCCCV
maaile - CVVVCV
aortla - VVCCCV
oktrua - VCCCVV
taoizm - CVVVCC
stereo - CCVCVV
yönetim - CVCVCVC
zatürre - CVCVCCV
zırvana - CVCCVCV
ölçüsel - VCCVCVC
özellik - VCVCCVC
üretici - VCVCVCV
ürküntü - VCCVCCV
kurtçuk - CVCCCVC
kruvaze - CCVCVCV
krampon - CCVCCVC
teessüf - CVVCCVC
zooloji - CVVCVCV
enstitü - VCCCVCV
cezaevi - CVCVVCV
ağartma - VCVCCCV
satranç - CVCCVCC
kramplı - CCVCCCV
ailesel - VVCVCVC
orduevi - VCCVVCV
penguen - CVCCVVC
itaatçi - VCVVCCV
ideolog - VCVVCVC
ailemle - VVCVCCV
ekinoks - VCVCVCC
maestro - CVVCCCV
kreatif - CCVVCVC
stresli - CCCVCCV
aitliğe - VVCCVCV
müdafaa - CVCVCVV
frekans - CCVCVCC
karstlı - CVCCCCV
dadaizm - CVCVVCC
flüorla - CCVVCCV
stresin - CCCVCVC
suikast - CVVCVCC
ekspres - VCCCCVC
iptidai - VCCVCVV
aysberg - VCCCVCC
aorttan - VVCCCVC
geoidin - CVVVCVC
protein - CCVCVVC
aneroit - VCVCVVC
arkaizm - VCCVVCC
ansambl - VCCVCCC
geoitle - CVVVCCV
neozoik - CVVCVVC
yıldırım - CVCCVCVC
zararsız - CVCVCCVC
tarayıcı - CVCVCVCV
özverili - VCCVCVCV
diaspora - CVVCCVCV
pediatri - CVCVVCCV
arkaüstü - VCCVVCCV
müracaat - CVCVCVVC
aksesuar - VCCVCVVC
zindancı - CVCCVCCV
üstlenme - VCCCVCCV
uyarılar - VCVCVCVC
üsteğmen - VCCVCCVC
deistler - CVVCCCVC
üfürükçü - VCVCVCCV
egoistçe - VCVVCCCV
aitlerdi - VVCCVCCV
özetleme - VCVCCVCV
akordeon - VCVCCVVC
aorttaki - VVCCCVCV
denklemi - CVCCCVCV
presleme - CCVCCVCV
ekstralı - VCCCCVCV
strateji - CCCVCVCV
pankreas - CVCCCVVC
frambuaz - CCVCCVVC
kraterli - CCVCVCCV
prosedür - CCVCVCVC
antrikot - VCCCVCVC
triatlon - CCVVCCVC
panteizm - CVCCVVCC
yanıltma - CVCVCCCV
asbestli - VCCVCCCV
kainatın - CVVCVCVC
geoitler - CVVVCCVC
fiilimsi - CVVCVCCV
elektron - VCVCCCVC
füzeatan - CVCVVCVC
tramplen - CCVCCCVC
stresten - CCCVCCVC
angström - VCCCCCVC
dünyaevi - CVCCVVCV
proteini - CCVCVVCV
piyanist - CVCVCVCC
atletizm - VCCVCVCC
reeskont - CVVCCVCC
aeroloji - VVCVCVCV
itaatsiz - VCVVCCVC
aitçilik - VVCCVCVC
ilanıaşk - VCVCVVCC
arkeolog - VCCVVCVC
ideoloji - VCVVCVCV
aidatsız - VVCVCCVC
tungsten - CVCCCCVC
kontrast - CVCCCVCC
greyfurt - CCVCCVCC
kreozotu - CCVVCVCV
anarşist - VCVCCVCC
maailece - CVVVCVCV
idealist - VCVVCVCC
istisnai - VCCVCCVV
kontekst - CVCCVCCC
psikoloji - CCVCVCVCV
astronomi - VCCCVCVCV
kubbealtı - CVCCVVCCV
proteinli - CCVCVVCCV
devridaim - CVCCVCVVC
espritüel - VCCCVCVVC
kreasyonu - CCVVCCVCV
enflüanza - VCCCVVCCV
spiritüel - CCVCVCVVC
yaşanacak - CVCVCVCVC
özverisiz - VCCVCVCVC
teokratik - CVVCCVCVC
vukuatsız - CVCVVCCVC
politeist - CVCVCVVCC
amfiteatr - VCCVCVVCC
ivmeölçer - VCCVVCCVC
vedalaşma - CVCVCVCCV
uydurukçu - VCCVCVCCV
taahhütlü - CVVCCVCCV
poliandri - CVCVVCCCV
arkaizmle - VCCVVCCCV
cıvıltılı - CVCVCCVCV
ısmarlama - VCCVCCVCV
seansları - CVVCCCVCV
rezervuar - CVCVCCVVC
kamuoyuna - CVCVVCVCV
arkeoloji - VCCVVCVCV
paleozoik - CVCVVCVVC
rastlaşıp - CVCCCVCVC
gladyatör - CCVCCVCVC
enstrüman - VCCCCVCVC
stratejik - CCCVCVCVC
gerdirtme - CVCCVCCCV
ekspresti - VCCCCVCCV
arttırttı - VCCCVCCCV
muadilini - CVVCVCVCV
geoitleri - CVVVCCVCV
neozoikte - CVVCVVCCV
branşları - CCVCCCVCV
spreyleme - CCCVCCVCV
kontrpiye - CVCCCCVCV
angströme - VCCCCCVCV
kontrpuan - CVCCCCVVC
yırtmaçlı - CVCCCVCCV
programlı - CCVCCVCCV
stresimle - CCCVCVCCV
etimoloji - VCVCVCVCV
aitliğimi - VVCCVCVCV
uruguaylı - VCVCVVCCV
reformist - CVCVCCVCC
eklektizm - VCCVCCVCC
reeksport - CVVCCCVCC
ideografi - VCVVCCVCV
areometre - VCVVCVCCV
mumaileyh - CVCVVCVCC
aktüalizm - VCCVVCVCC
pankreası - CVCCCVVCV
frambuazı - CCVCCVVCV
zorlaşmak - CVCCVCCVC
traverten - CCVCVCCVC
enflasyon - VCCCVCCVC
böğürtlen - CVCVCCCVC
eksiltmek - VCCVCCCVC
vandalizm - CVCCVCVCC
kloroform - CCVCVCVCC
meşruiyet - CVCCVVCVC
stereotip - CCVCVVCVC
otobüsler - VCVCVCCVC
aitsizlik - VVCCVCCVC
araştırma - VCVCCVCCV
aortlarda - VVCCCVCCV
iadeleşme - VVCVCVCCV
ailelerin - VVCVCVCVC
mütalaası - CVCVCVVCV
aksesuarı - VCCVCVVCV
jeotermal - CVVCVCCVC
abartmama - VCVCCCVCV
atatürkçü - VCVCVCCCV
ideolojik - VCVVCVCVC
bahriyeci - CVCCVCVCV
uzaylılar - VCVCCVCVC
ailemdeki - VVCVCCVCV
egoistlik - VCVVCCCVC
traversli - CCVCVCCCV
suikastçı - CVVCVCCCV
stoacılık - CCVVCVCVC
kreozotla - CCVVCVCCV
ekonomist - VCVCVCVCC
feodalizm - CVVCVCVCC
aminoasit - VCVCVVCVC
akordeonu - VCVCCVVCV
geoidinin - CVVVCVCVC
maaileydi - CVVVCVCCV
megahertz - CVCVCVCCC
hornblent - CVCCCCVCC
kontrplak - CVCCCCCVC
transport - CCVCCCVCC
sfenksler - CCVCCCCVC
rölativite - CVCVCVCVCV
aykırılama - VCCVCVCVCV
zaaflarını - CVVCCVCVCV
mozaiklere - CVCVVCCVCV
anneanneme - VCCVVCCVCV
paraguaylı - CVCVCVVCCV
aksesuarcı - VCCVCVVCCV
paraboloit - CVCVCVCVVC
odyovizüel - VCCVCVCVVC
çiftçimize - CVCCCVCVCV
enstrümanı - VCCCCVCVCV
stokçuluğa - CCVCCVCVCV
stratejisi - CCCVCVCVCV
pankreasçı - CVCCCVVCCV
frambuazlı - CCVCCVVCCV
kristaloit - CCVCCVCVVC
zırdelilik - CVCCVCVCVC
grekoromen - CCVCVCVCVC
altyapısal - VCCCVCVCVC
penguenler - CVCCVVCCVC
stereoskop - CCVCVVCCVC
pleistosen - CCVVCCVCVC
sığışırdık - CVCVCVCCVC
ampütasyon - VCCVCVCCVC
muallimlik - CVVCCVCCVC
veliahtlık - CVCVVCCCVC
arkaizmdir - VCCVVCCCVC
tutkuluydu - CVCCVCVCCV
grafometre - CCVCVCVCCV
örtmedikçe - VCCCVCVCCV
panteistçe - CVCCVVCCCV
kreasyonda - CCVVCCVCCV
yüzüklerin - CVCVCCVCVC
eklentisel - VCCVCCVCVC
deistlerin - CVVCCCVCVC
empermeabl - VCCVCCVVCC
hangardaki - CVCCVCCVCV
gravürleri - CCVCVCCVCV
antlaşmada - VCCCVCCVCV
semtürreis - CVCCVCCVVC
etimolojik - VCVCVCVCVC
idealleşen - VCVVCCVCVC
aitliğimin - VVCCVCVCVC
izazuikram - VCVCVVCCVC
kırlentler - CVCCVCCCVC
frekanslar - CCVCVCCCVC
eksprestir - VCCCCVCCVC
ölçtürtmek - VCCCVCCCVC
uyuşturucu - VCVCCVCVCV
akordeoncu - VCVCCVVCCV
aortlarına - VVCCCVCVCV
garipleşme - CVCVCCVCCV
uzmanlarca - VCCVCCVCCV
nüanslarda - CVVCCCVCCV
ifadesizce - VCVCVCVCCV
ısıölçerle - VCVVCCVCCV
aitliğiyle - VVCCVCVCCV
imalathane - VCVCVCCVCV
egoistleri - VCVVCCCVCV
aitsizliği - VVCCVCCVCV
popülistçe - CVCVCVCCCV
aspidistra - VCCVCVCCCV
reeskontlu - CVVCCVCCCV
spektrumun - CCVCCCVCVC
streptokok - CCCVCCVCVC
karstlaşan - CVCCCCVCVC
feldspatlı - CVCCCCVCCV
platformda - CCVCCVCCCV
kompleksli - CVCCCVCCCV
yurttaşlık - CVCCCVCCVC
plastikler - CCVCCVCCVC
stratosfer - CCCVCVCCVC
şaşırtsana - CVCVCCCVCV
açtırtmama - VCCVCCCVCV
meteorolog - CVCVVCVCVC
osteolojik - VCCVVCVCVC
biyoenerji - CVCVVCVCCV
arkeometri - VCCVVCVCCV
sürrealite - CVCCVVCVCV
stereofoni - CCVCVVCVCV
tramplenci - CCVCCCVCCV
kontrplağı - CVCCCCCVCV
müracaatım - CVCVCVVCVC
aksesuarım - VCCVCVVCVC
pozitivist - CVCVCVCVCC
ortopedist - VCCVCVCVCC
konformist - CVCCVCCVCC
kloroplast - CCVCVCCVCC
fortepiano - CVCCVCVVCV
spiritüeli - CCVCVCVVCV
teferruata - CVCVCCVVCV
incirliova - VCCVCCVVCV
elektronik - VCVCCCVCVC
elektronik - CVVCVCVCCV
elektrikli - VCVCCCVCCV
kaotikliği - CVVCVCCVCV
alüvyonsuz - VCVCCVCCVC
ebeveynlik - VCVCVCCCVC
aidiyetlik - VVCVCVCCVC
anaokuluna - VCVVCVCVCV
aidatınızı - VVCVCVCVCV
striptizci - CCCVCCVCCV
ideologlar - VCVVCVCCVC
anarşistçe - VCVCCVCCCV
jeosantrik - CVVCVCCCVC
kreatörler - CCVVCVCCVC
ailendendi - VVCVCCVCCV
aidatların - VVCVCCVCVC
idealizmle - VCVVCVCCCV
stoacılara - CCVVCVCVCV
aminoaside - VCVCVVCVCV
elipsoidal - VCVCCVVCVC
oportünist - VCVCCVCVCC
sürrealizm - CVCCVVCVCC
postmodern - CVCCCVCVCC
pragmatizm - CCVCCVCVCC
gayritabii - CVCCVCVCVV
sfenkslere - CCVCCCCVCV
paleozoiğe - CVCVVCVVCV
kontekstle - CVCCVCCCCV
pankreasım - CVCCCVVCVC
kontrpuana - CVCCCCVVCV
otoerotizm - VCVVCVCVCC
izomorfizm - VCVCVCCVCC
maailenize - CVVVCVCVCV
maaileydik - CVVVCVCCVC
geoitlerin - CVVVCCVCVC
latifundia - CVCVCVCCVV
getirttirt - CVCVCCCVCC
amalierbaa - VCVCVVCCVV
meteoroloji - CVCVVCVCVCV
iddianamede - VCCVVCVCVCV 
paleozoikte - CVCVVCVVCCV
müdafaasına - CVCVCVVCVCV
aksesuarını - VCCVCVVCVCV
otomobilini - VCVCVCVCVCV
ateizminizi - VCVVCCVCVCV 
aitliğimizi - VVCCVCVCVCV
onomatopeik - VCVCVCVCVVC
sıralamakta - CVCVCVCVCCV
ültimatomla - VCCVCVCVCCV 
müessesemde - CVVCCVCVCCV
masaüstünde - CVCVVCCVCCV
inşaatlaşma - VCCVVCCVCCV
monoteizmde - CVCVCVVCCCV
amfiteatrda - VCCVCVVCCCV
yüzyılımızı - CVCCVCVCVCV
blokelediği - CCVCVCVCVCV 
antropoloji - VCCCVCVCVCV
penguenlere - CVCCVVCCVCV
kreasyonunu - CCVVCCVCVCV
zümrüdüanka - CVCCVCVVCCV
enflüanzaya - VCCCVVCCVCV
şeytanılain - CVCCVCVCVVC
aksesuarlar - VCCVCVVCCVC
hurafecilik - CVCVCVCVCVC
vukuatların - CVCVVCCVCVC
reaktörünün - CVVCCVCVCVC
ortaöğretim - VCCVVCCVCVC
devalüasyon - CVCVCVVCCVC
rakiplerini - CVCVCCVCVCV
uzmanlığına - VCCVCCVCVCV
seanslarıma - CVVCCCVCVCV
herifçioğlu - CVCVCCVVCCV
hiperboloit - CVCVCCVCVVC
yürüyenlere - CVCVCVCCVCV
muallaklığı - CVVCCVCCVCV
öldürülmesi - VCCVCVCCVCV
veliahtlığı - CVCVVCCCVCV
homoseksüel - CVCVCVCCVVC
proteinimsi - CCVCVVCVCCV
beddualarla - CVCCVVCVCCV
stereografi - CCVCVVCCVCV
oluvermekte - VCVCVCCVCCV
egoistleşme - VCVVCCCVCCV
aitleştirme - VVCCVCCVCCV
üreteçlerin - VCVCVCCVCVC
egoistliğin - VCVVCCCVCVC
aitleştiren - VVCCVCCVCVC
ajitatörlük - VCVCVCVCCVC
itaatkarlık - VCVVCCVCCVC
aitsinizdir - VVCCVCVCCVC
meteoritler - CVCVVCVCCVC
antialerjik - VCCVVCVCCVC
proteininin - CCVCVVCVCVC
virtüözüdür - CVCCVVCVCVC
istisnaidir - VCCVCCVVCVC
rezervuarın - CVCVCCVVCVC
aortlarının - VVCCCVCVCVC
açıkladılar - VCVCCVCVCVC
akordeonlar - VCVCCVVCCVC
aortlarında - VVCCCVCVCCV
üzüldüğümle - VCVCCVCVCCV
aortlarında - VVCCCVCVCCV
üzüldüğümle - VCVCCVCVCCV
kraliyettir - CCVCVCVCCVC
astrologlar - VCCCVCVCCVC
düzgüsellik - CVCCVCVCCVC
panteistlik - CVCCVVCCCVC
kreasyonlar - CCVVCCVCCVC
yoksullukla - CVCCVCCVCCV
sloganlarla - CCVCVCCVCCV
enflasyonla - VCCCVCCVCCV
piknikçiler - CVCCVCCVCVC
ilkselcilik - VCCCVCCVCVC
primatların - CCVCVCCVCVC
filizlenmek - CVCVCCVCCVC
üstünleşmek - VCCVCCVCCVC
deistlerden - CVVCCCVCCVC
şartnameler - CVCCCVCVCVC
prangalamak - CCVCCVCVCVC
enstrümanım - VCCCCVCVCVC
stratejimiz - CCCVCVCVCVC
pankreastan - CVCCCVVCCVC
frambuazdan - CCVCCVVCCVC
rastladıkça - CVCCCVCVCCV
planlamakta - CCVCCVCVCCV
ekstralarla - VCCCCVCVCCV
stratejikti - CCCVCVCVCCV
kentleşmeye - CVCCCVCCVCV
klikleşmesi - CCVCCVCCVCV
stratosferi - CCCVCVCCVCV
ekstremliğe - VCCCCVCCVCV
dikdörtgene - CVCCVCCCVCV
büktürttüğü - CVCCVCCCVCV
stilistliğe - CCVCVCCCVCV
ölçtürtmedi - VCCCVCCCVCV
trençkotumu - CCVCCCVCVCV
streptokoka - CCCVCCVCVCV
kontrpiyede - CVCCCCVCVCV
kontrpuanlı - CVCCCCVVCCV
popülistlik - CVCVCVCCCVC
ehlibeytten - VCCVCVCCCVC
reeskontlar - CVVCCVCCCVC
primitivizm - CCVCVCVCVCC
nasyonalizm - CVCCVCVCVCC
anglikanizm - VCCCVCVCVCC
reformculuk - CVCVCCCVCVC
asbestlidir - VCCVCCCVCVC
dürüstleşme - CVCVCCCVCCV
ilginçleşti - VCCVCCCVCCV
emperyalizm - VCCVCCVCVCC
determinizm - CVCVCCVCVCC
putperestçe - CVCCVCVCCCV
kloroformlu - CCVCVCVCCCV
metamorfizm - CVCVCVCCVCC
irredantizm - VCCVCVCCVCC
ayrıştırtma - VCCVCCVCCCV
monarşizmle - CVCVCCVCCCV
greyfurtlar - CCVCCVCCCVC
komplekstir - CVCCCVCCCVC
branşlaşmak - CCVCCCVCCVC
stresliydim - CCCVCCVCCVC
karstlaşmış - CVCCCCVCCVC
kontrplağın - CVCCCCCVCVC
aposteriori - VCVCCVCVVCV
paleozoiğin - CVCVVCVVCVC
geoidimizin - CVVVCVCVCVC
aminoasidin - VCVCVVCVCVC
paraboloide - CVCVCVCVVCV
aidatlarımı - VVCVCCVCVCV
aminoasitle - VCVCVVCVCCV
akordeonunu - VCVCCVVCVCV
faaliyetini - CVVCVCVCVCV
ideologları - VCVVCVCCVCV
iaşelerinde - VVCVCVCVCCV
ideolojidir - VCVVCVCVCVC
ideolojimle - VCVVCVCVCCV
ailedekiler - VVCVCVCVCVC
aidiyetliği - VVCVCVCCVCV
müddeiumumi - CVCCVVVCVCV
hisseişayia - CVCCVVCVCVV
espritüeldi - VCCCVCVVCCV
binaenaleyh - CVCVVCVCVCC
kristaloide - CCVCCVCVVCV
amerikanizm - VCVCVCVCVCC
videobantta - CVCVVCVCCCV
feodalizmle - CVVCVCVCCCV
pankreasını - CVCCCVVCVCV
stoacıların - CCVVCVCVCVC
kreatörlere - CCVVCVCCVCV
stoacılarda - CCVVCVCVCCV
uyuşmazlığa - VCVCCVCCVCV
bienalinden - CVVCVCVCCVC
akortlamaya - VCVCCCVCVCV
teamüllerin - CVVCVCCVCVC
teoremlerle - CVVCVCCVCCV
elementleri - VCVCVCCCVCV
aidatlardan - VVCVCCVCCVC
suikastları - CVVCVCCCVCV
idealisttir - VCVVCVCCCVC
ekonomistle - VCVCVCVCCCV
müddeialeyh - CVCCVVVCVCC
kontrpuanın - CVCCCCVVCVC
jeosantrizm - CVVCVCCCVCC
uzaklaştırt - VCVCCVCCVCC
egosantrizm - VCVCVCCCVCC
megahertzle - CVCVCVCCCCV
anarşistler - VCVCCVCCCVC
amorflaşmış - VCVCCCVCCVC
sfenkslerde - CCVCCCCVCCV
kontrplakla - CVCCCCCVCCV
kontekstten - CVCCVCCCCVC
sfenkslerin - CCVCCCCVCVC
hornblentli - CVCCCCVCCCV
affedebilen - VCCVCVCVCVC
ait - VVC
şiir - CVVC
trio - CCVV
aort - VVCC
